20
20
347
246
100
500
500
500
w w w w w w w w w w w w w w w w w w w w 
w g g g g g g g g g g g g g g g g g g w 
w g g g g g g g g g g g g g g g g g g w 
w g g g g g g g g g g g g g g g g g g w 
w g g g g g g g g g g g g g g g g g g w 
w g g g g g g g g g g g g g W W g g g w 
w g g g g g g g g g g g g W W W W g g w 
w g g g g g g g g g g g g W W W W g g w 
w g g g g g g g g g g g g g W W g g g w 
w g g g g g g g g g g g g g g g g g g w 
w g g g g g g g g g g g g g g g g g g w 
w g g g g g g g g g g g g g g g g g g w 
w g g g g g w g g g g g g g g g g g g w 
w g g g g g w g g g g g g g g g g g g w 
w g g g g g w w w g g g g g g g g g g w 
w g g g g g g g g g g g g g g g g g g w 
w g g g g g g g g g g g g g g g g g g w 
w g g g g g g g g g g g g g g g g g g w 
w g g g g g g g g g g g g g g g g g g w 
w w w w w w w w w w w w w w w w w w w w 
